####################
#..................#
#...P..............#
#..................#
#..##........##....#
#..................#
#..................#
#..................#
#..................#
#..................#
#....##........##..#
#..................#
#..............P...#
#..................#
####################